1111111111111111111
1E0C0P0011100000111
1000000001000100001
1100000000010100101
1000010010010000001
1000000000000000001
1001000000100000001
1000000000000000001
1001000000100000001
1001000000000000001
1111111111111111111