1111111111111111111
10000000C00000EP111
1111111111111111111