1111111111111111111
1E000P0011100000111
1000000001000100001
1100000000010100101
1000010010010000001
1000I00000000I00001
10010000C0100000001
10000C0I00000C00001
1001000000100000001
100100000000000C001
1111111111111111111